11111111111
1EC00000011
11100001011
1100001P011
11111111111