11111111111
10C00000011
111000C1011
110E001P011
11111111111