1111111111111
10C0000000C11
111C00C110011
110E011P00C11
10C0001110011
111C00C001111
10C0010000C11
111C11C0C1C11
1111111111111